R 1600 800
NO cub3d_tester/textures/wall_1.xpm
SO cub3d_tester/textures/wall_2.png
WE cub3d_tester/textures/wall_3.xpm
EA cub3d_tester/textures/wall_4.xpm
S cub3d_tester/textures/sprite_1.xpm
F 184,113,39
C 51,198,227

        1111111111111111111111111
        1000000000110000000111211
        1011000001110000020110001
        1021000000000000000110001
111111111011000001110000000000001
100000000011000001110111111111111
11110111111111011100000010001
11110111111111011101010010001
11000000110101011100000012001
10002000000000001100000000001
10000000000000001101010010001
11000001110101011111011110N0111
11110111 1110101 101111010001
11111111 1111111 111111111111
