SO    ./textures/forest.xpm
WE    ./textures/apple_golden.xpm
NO    ./textures/meilvf.xpm
EA	   ./textures/meilv.xpm
R       640 480
S   ./textures/baked_potato.xpm
F ./textures/grass.xpm
C  250,206,135

1 1 1 1 1 1 1 1 1 1 1 1 1 1 1 1 1 1 1 1 1 1 1 1
1 0 0 2 0 0 0 0 0 0 0 0 0 0 0 0 0 0 0 0 0 0 0 1
1 0 0 0 0 0 0 0 0 0 0 0 0 0 0 0 0 0 0 0 0 0 0 1
1 0 0 0 0 0 0 0 0 0 0 0 0 0 0 0 0 0 0 0 0 0 0 1
1 0 0 0 0 0 1 1 1 1 2 0 0 0 0 1 1 1 1 0 0 0 0 1
1 0 0 0 0 0 2 0 0 0 2 0 0 0 0 0 0 0 1 0 0 0 0 1
1 0 0 0 0 0 1 0 0 0 1 0 0 0 0 0 0 1 1 0 0 0 0 1
1 0 0 0 0 0 1 0 0 0 1 0 0 0 0 0 0 0 0 0 0 0 0 1
1 1 0 0 0 1 1 1 0 1 1 0 0 0 1 1 0 1 0 1 0 0 0 1
1 0 0 0 0 0 0 1 0 0 0 0 0 0 0 0 0 0 1 0 0 0 0 1
1 0 0 2 0 0 0 1 0 0 0 0 0 0 0 0 0 0 1 0 0 0 0 1
1 0 0 0 0 0 0 1 1 0 0 0 0 0 0 0 0 0 0 3 1 1 1 1
1 1 1 1 1 1 1 1 0 0 0 0 0 0 0 0 2 0 1 0 1 1 1 1
1 1 0 0 0 0 0 0 3 0 0 0 5 0 0 0 0 0 1 0 0 0 0 1
1 0 2 0 0 0 0 0 4 0 0 0 0 0 0 0 0 0 1 0 0 0 0 1
1 1 3 0 0 0 3 0 1 2 0 3 1 1 1 0 1 1 1 1 1 1 1 1
1 1 1 1 1 1 1 1 1 0 0 0 0 0 0 0 4 0 1 0 0 0 0 1
1 1 0 1 0 0 0 0 1 0 0 0 2 0 0 0 0 0 1 0 3 0 0 1
1 0 0 0 0 0 1 0 1 0 0 0 0 0 0 0 0 0 2 0 0 2 0 1
1 1 0 0 0 0 0 6 1 0 2 0 S 0 2 0 0 0 1 0 4 0 0 1
1 1 0 0 1 1 1 1 1 0 0 0 2 0 1 1 1 1 1 1 1 5 0 1
1 1 0 0 0 0 0 0 0 0 0 0 2 0 0 0 0 0 2 3 0 0 0 1
1 0 1 1 1 1 1 1 1 0 0 0 0 0 0 0 0 0 1 1 1 1 1 1
1 1 1 1 1 1 1 1 1 1 1 1 1 1 1 1 1 1 1 1 1 1 1 1