SO    ./textures/forest.xpm
WE    ./textures/apple_golden.xpm
NO    ./textures/meilvf.xpm
EA	   ./textures/meilv.xpm
R       640 480
S   ./textures/baked_potato.xpm
F ./textures/grass.xpm
C 250,206,135

111111111111111111111111
100200000000000000000001
100000000000000003000001
100000000700000000000001
100000111120000111100001
100000200020000000100001
130000103010000001100701
100000100010000000000001
110001110110001101010001
100000010000000000000001
100200010070007000000001
100000011000000000000001
111111110000000020200001
100000003000500000100001
100000004030000000303001
100000000000007000000001
111111111000007040300001
110100001000200000000001
100000111000000000200001
110000061020S02000000201
110011111000200000000001
110000000000200500200001
101111111000000000003001
111111111111111111111111